1111111
1111111
1111111
111E111
1111111