111111111
1000E0001
101111101
101000101
1010P0101
101C0E101
101111101
100000001
111111111
111111111