111111
100011
10P01
1C0E11
111111