11111111111111111111
11100001111111100011
11100001111110000011
11100001111110000011
10000001111110000011
10000000000000000011
1P000000000000000001
10000000000000000001
10000001101111100001
1110000100000N100001
11100001N00C00100001
1110000100000N100001
111000011111001E0001
11111111111111111111