1111111111111111111111111111
111111E000000000111000111111
1111110000000000000000111111
1111111011100000000000011111
1111111010000110011000000111
1111111010000111100100000011
1111100C10000100000011110011
1111001100001000000CN0010011
1111010000010000000000010111
1E00000000010000000000100111
1EP0000010010011000000100111
1100001111010011011000100111
1100001111011000010001000111
1110001100010111000000000111
11110000000N0000000000110111
1111000000000001000000110111
1111000000001111000110000111
1111000000011111000111001111
1111110111111111111111111111
1111111111111111111111111111