11111111111111111111111
1E0000000000000C00000C1
10100101001000001010011
10100100101010100011111
1P0000000C00C00000100C1
11111111111111111111111
