11111111111111111
1C010000000C00101
1C010000000C00101
10000111110010011
10000111110010011
1P0011E000000C011
11111111111111111
