1111111111
1001000001
1000011101
1P0011E001
10000010C1
1000001001
1001000001
1001000001
1001000001
1111111111