111111111111111
100000000000001
101111111111101
101000000000101
1010E00000C0101
101000000000101
101000000000101
1010000P0000101
101000000000101
101000000000101
1010C00000C0101
101000000000101
101111111111101
100000000000001
111111111111111
111111111111111