111111
1P0001
100001
100111
110001
111001
1E1001
101001
101001
101001
100001
1000C1
111111