1111111111111
1111100000011
100100N0000C1
1000011111001
1P0011E000N01
1111111111111