111111111111
111110000011
111110000001
11111P100001
11111E100001
111111100001
111110000001
111110011101
100010010001
10000001C0C1
100C0001C0C1
100000100001
100000100001
100111111001
111111111111