11111111111111
1111111C001111
11111110000111
11111E10000111
11111011101111
11111010000111
11111010000001
11111011100001
10000000100001
10000000100011
10011101100011
10010000000011
10010000000011
110111P0000111
11001111100111
11001111100111
11111111111111